00000000000000000000
00000000000000000000
00000000111100000000
000000001pL100000000
00000011100111000000
000000101xx101000000
00000010xxxx01000000
00000010x11x01000000
0000001xxxxxx1000000
00000011100111000000
000000001e0100000000
00000000100100000000
00000000111100000000
00000000000000000000
00000000000000000000
