11111111111111111111
11111111111111111111
10000000000000000001
10pL0000000000000001
10000000000000000001
11111111111111110001
11111111111111110001
11111111111111110001
11111111111111110001
11111111111111110001
10000000000000000001
10e00000000000000001
10000000000000000001
11111111111111111111
11111111111111111111
