00000000000000000000
00000000000000000000
00000000000000000000
000000xxX00111110000
0000111110010e010000
000010x01X0100010000
000010p01111f1110000
00001000c00101000000
00001110101001X00000
00000010t01001100000
0000X010000c001X0000
0000xx110001111x0000
0000xx11111111100000
00000000000000000000
00000000000000000000
