00000000000000000000
00000000000000000000
00000000000000000000
00000011111110000000
00000010000010000000
0001111o111011111000
000100x0000000001000
000100x0000X00p01000
0001eL1X011110111000
00010010000000111000
00011110o01111111000
00000011111000000000
00000000000000000000
00000000000000000000
00000000000000000000
