00000000000000000000
00000000000000000000
00000000000000000000
00011111111111111000
00010010000000001000
000100o0000X0pL01000
0001e01x111110111000
00010010000000111000
00011111111111111000
00000000000000000000
00000000000000000000
00000000000000000000
00000000000000000000
00000000000000000000
00000000000000000000
