00000000000000000000
00000000000000000000
00000000000000000000
00000001111110000000
00000001tp0t10000000
00000001000010000000
00000111xxxx11100000
000001t000000t100000
00000100xxxx00100000
00000100xxex00100000
000001t0xxxx0t100000
00000111111111100000
00000000000000000000
00000000000000000000
00000000000000000000
