00000000000000000000
00000000000000000000
00000000000000000000
00000000000000000000
00000000000000000000
00000111111111100000
000001exxxxxxe100000
000001xxxxxxxx100000
000001xxx00xxx100000
000001o000000o100000
00000111100111100000
000000001pL100000000
00000000111100000000
00000000000000000000
00000000000000000000
