00000000000000000000
00000000000000000000
00000000000000000000
00000011111111000000
0000001p001001000000
000000100xxx01000000
000001111111x1100000
000001t00000xt100000
00000110000001100000
0000001e000001000000
00000011111111000000
00000000000000000000
00000000000000000000
00000000000000000000
00000000000000000000
