00000000000000000000
00000000000000000000
00000000000000000000
00000000000000000000
00000000000000000000
00000111111111100000
000001exxxxxxe100000
000001xxxxxxxx100000
000001xxx00xxx100000
00000100000000100000
00000111100111100000
000000001p0100000000
00000000111100000000
00000000000000000000
00000000000000000000
