00000000000000000000
00000000000000000000
00000000000000000000
00000001111110000000
0000000100xx10000000
0000000100xx10000000
0000000100xx10000000
0000111100xx11111000
00001t0x011x00001000
000010px011x00et1000
0000100x011x00001000
00001111111111111000
00000000000000000000
00000000000000000000
00000000000000000000
