00000000000000000000
00000000000000000000
00000000000000000000
00000000000000000000
00000111111111100000
000001L0011111100000
0000010p0x000f100000
00000100011100100000
00000111110000100000
000001e0xx0o00100000
00000100xx0000100000
00000111111111100000
00000000000000000000
00000000000000000000
00000000000000000000
