00000000000000000000
00000000000000000000
00000000000000000000
00111111111111111000
001p0100xx0000011000
00100x00xx0010xx1000
00111111111111xx1000
001000xxxxxxx0001000
00101111111111111000
001000010x0010e01000
00100000x10000001000
00111111111111111000
00000000000000000000
00000000000000000000
00000000000000000000
