00000000000000000000
00000000000000000000
00000000000000000000
00000000000000000000
00000000000000000000
00000111111110000000
00000100xxx010000000
00000100xxx010000000
00000101111011111100
0000010p00xx00000100
000001111111110e0100
00000000000001000100
00000000000001111100
00000000000000000000
00000000000000000000
