00000000000000000000
00000000000000000000
00000000011100000000
0000001111o110000000
00000010xxxx11100000
000000100x001e100000
0000001000X0f0100000
0000001Lp00011100000
00000010000010000000
000000111x1110000000
000000001f1000000000
000000001o1000000000
00000000111000000000
00000000000000000000
00000000000000000000
