00000000000000000000
00000000000000000000
00000000000000000000
00000000000000000000
000000t111111t000000
000000100x0111000000
0000001xx00111000000
0000001xxX0x11000000
000000100x00e1000000
0000001p00X001000000
00000011110011000000
000000t111111t000000
00000000000000000000
00000000000000000000
00000000000000000000
