00000000000000000000
00000000000000000000
00000000011110000000
00000000010010000000
00000000010011110000
00001111110000e10000
00001000010000010000
0000100001ff11110000
000010X0000010000000
0000100L00po10000000
00001000000010000000
00001000000010000000
00001111111110000000
00000000000000000000
00000000000000000000
