00000000000000000000
00000000000000000000
00000000111100000000
00000000100100000000
000000111eL111000000
00000010000001000000
00000010000001000000
0000001X0ccX01000000
00000010000001000000
00000010p00001000000
00000010000x01000000
00000011111111000000
00000000000000000000
00000000000000000000
00000000000000000000
