00000000000000000000
00000000000000000000
00000000000000000000
00000000000000000000
00000111111111100000
00000100010000100000
00000100px0000100000
00000100010000100000
00000111110000100000
000001e0xx0000100000
00000100xx0000100000
00000111111111100000
00000000000000000000
00000000000000000000
00000000000000000000
